City Ruins,12,19
~~~~~~~~~~~~~~~~~~~
~~~~~~~~~~~~~~~~~~~
~~~~~~~...~~~~~~~~~
~~~..........~~~~~~
.....------..~~~~~~
.....-....-...~~~~~
.....-....-...~~~~~
.....-....-...~~~~~
.....--..--..~~~~~~
.............~~~~~~
~~~~~.....~~~~~~~~~
~~~~~~~~~~~~~~~~~~~

_spawn,9,5
world,9,4,4,13
world,3,4,4,13