City,22,50
..................................................
..................................................
..................................................
......--------------------------------------......
......-....................................-......
......-.---------....---------.....-------.-......
......-.-.......-....-.......-..@..-.....-.-......
......-.-.......-.@..-.......-..@..-.....-.-......
......-.-.......-.@..-.......-.....---.---.-......
......-.----.----....----.----..,,,,,,,,...-......
......-....,,,,,,,,,,,,,,,,,,,,,,,.------..-......
......-.............@,,,,@..@@.....-....-..-......
......-.....@@......,,~~,,.........----.-..-......
......-.---------..,,~~~~,,..-------....-..-......
......-.-.......-...,,~~,,...-.....-....-..-......
......-~-........,,,,,,,,,,,,...........-..-......
......-~-.......-....@,,@....------------.@-......
......-~---------.....,,................@@@-......
......---------------.,,.-------------------......
......................,,..........................
......................,,..........................
..................................................

_spawn,19,22
world,19,20,5,13
world,20,21,5,14
world,20,22,5,14
world,20,23,5,14
world,20,24,5,14
world,19,25,5,15