World,30,74
~~~~~~~~~~~~~~~~~~~~~~~~~~~~~~~~~~~~~~~~~~~~~~~~~~~~~~~~~~~~~~~~~~~~~~~~~~
~~~~~~~~~~~~~~~~~~~~~~~~~~~~~~~~~~~~~~~~~~~~~~~~~~~~~~~~~~~~~~~~~~~~~~~~~~
~~~~~~~~~~~~~...~~~~~~~~~~~~~~~~~~~~~~~~~~~~~~~~~~~~~~~~~~~~~~~~~~~~~~~~~~
~~~~~~~~~~~~.....@@~~~~~~~~~~~~~~~~~~~~~~~~~~~~~~~~~~~~~~..............~~~
~~~~~~~~~~....^...@@@.@..~~~~~~~~~~~~~~~~~~~~~~~.......................~~~
~~~~~~~~~..........@@@@...~~~~~~~~~~~~~~~~~~~~~........................~~~
~~~~~~~~~.........@.@@@@..~~~~~~~~~~~~~~~~~~~~~......@@................~~~
~~~~~~~~.............@...~~~~~~~~~~~~~~~~~~~~~~~....@@@@..............~~~~
~~~~~~~~.................~~~~~~~~~~~~~~~~~~~~~~~.....@@@@.~~@@......~~~~~~
~~~~~~~~~.....................~~~~~~~~~~~~~~~~~~~....@@@...~~~~~~~..~~~~~~
~~~~~~~.......@@@.~~~.........~~~~~~~~~~~~~~~~~~~.........@@.....~~~~~~~~~
~~~~~~~.....@@@~~~~~~.........~~~~~~~~~~~~~~~~~~~.................~~~~~~~~
~~~~~~~......~~~~~...........~~~~~~~~~~~~~~~~~~~~~...............~~~~~~~~~
~~~~~~~~.....~~~............~~~~~~~~~~~~~~~~~~~~~~.......~.....~~~~~~~~~~~
~~~~~~~~~~....................~~~~~~~~~~~~~~~~~~~~~~~~~~~~~~~~~~~~~~~~~~~~
~~~~~~~~~~~..........@..........~~~~~~~~~~~~~~~~~~~~~~~~~~~~~~~~~~~~~~~~~~
~~~~~~~~~~~~.......@@@@..........,~~~~~~~~~~~~~~~~~~~~..~~~~~~~~~~~~~~~~~~
~~~~~~~~~~~~.........@@.........,,~~~~~~~~~~~~~~~~~~~.......~~~~~~~~~~~~~~
~~~~~~~~~~~~~..................,,,~~~~~~~~~~~~~~~~~~............~~~~~~~~~~
~~~~~~~~~~~~~~.................~~~~~~~~~~~~~~~~~~...............~~~~~~~~~~
~~~~~~~~~~~~~~~~~..............~~~~~~~~~~~~~~~~~...............~~~~~~~~~~~
~~~~~~~~~~~~~~~~~..............~~~~~~~~~~~~~~~~...........@@...~~~~~~~~~~~
~~~~~~~~~~~~~~~~~.............~~~~~~~~~~~~~~~~~.........@@@...~~~~~~~~~~~~
~~~~~~~~~~~~~~~~~~~.........~~~~~~.~~~~~~~~~~~.........@@...~~~~~~~~~~~~~~
~~~~~~~~~~~~~~~~~~~~........~~~~~.......~~~~~~...........~~~~~~~~~~~~~~~~~
~~~~~~~~~~~~~~~~~~~~~......~~~~~~.......~~~~~~.........~~~~~~~~~~~~~~~~~~~
~~~~~~~~~~~~~~~~~~~~~~....~~~~~~.......~~~~~~~~~~~..~~~~~~~~~~~~~~~~~~~~~~
~~~~~~~~~~~~~~~~~~~~~~~~~~~~~~~~....~~~~~~~~~~~~~~~~~~~~~~~~~~~~~~~~~~~~~~
~~~~~~~~~~~~~~~~~~~~~~~~~~~~~~~~~~~~~~~~~~~~~~~~~~~~~~~~~~~~~~~~~~~~~~~~~~
~~~~~~~~~~~~~~~~~~~~~~~~~~~~~~~~~~~~~~~~~~~~~~~~~~~~~~~~~~~~~~~~~~~~~~~~~~

_spawn,5,14
city,4,14
oldworld,19,33