11,20
~~~~~~~~~.~~~~~~~~~~
~~~~~~~~...~~~~~~~~~
~~~~~~~.....~~~~~~~~
~~~~~~~.......~~~~~~
~~~~~.~~~...~..~~~~~
~~~~~.~~.....~~~~~~~
~~~~~..~~~~..~~~~~~~
~~~~~~...~~..~~~~~~~
~~~~~~~......~~~~~~~
~~~~~~~~~~.~~~~~~~~~
~~~~~~~~~..~~~~~~~~~

_spawn,2,9